Эйнштейн Альберт Германович	ФИЗ-11	Ньютон Исаак
Кюри Мария Склодовская	ФИЗ-11	Ньютон Исаак
Фарадей Майкл Джеймс	ФИЗ-11	Ньютон Исаак
Тесла Никола Джорджевич	ФИЗ-11	Ньютон Исаак
Галилей Галилео Андреа	ФИЗ-11	Ньютон Исаак
Гук Роберт Энтони	ФИЗ-11	Ньютон Исаак
Лоренц Хендрик Антон	ФИЗ-11	Ньютон Исаак
Максвелл Джеймс Клерк	ФИЗ-11	Ньютон Исаак
Гейзенберг Вернер Карл	ФИЗ-12	Планк Макс Карл
Шрёдингер Эрвин Рудольф	ФИЗ-12	Планк Макс Карл
Бор Нильс Хенрик	ФИЗ-12	Планк Макс Карл
Паули Вольфганг Эрнст	ФИЗ-12	Планк Макс Карл
Ферми Энрико Густаво	ФИЗ-12	Планк Макс Карл
Дирак Поль Адриен	ФИЗ-12	Планк Макс Карл
Борн Макс Густав	ФИЗ-12	Планк Макс Карл
Гаусс Карл Фридрих	МАТ-21	Эйлер Леонард Пауль
Коши Огюстен Луи	МАТ-21	Эйлер Леонард Пауль
Лагранж Жозеф Луи	МАТ-21	Эйлер Леонард Пауль
Фурье Жан Батист	МАТ-21	Эйлер Леонард Пауль
Абель Нильс Хенрик	МАТ-21	Эйлер Леонард Пауль
Гильберт Давид Юлиус	МАТ-21	Эйлер Леонард Пауль
Пуанкаре Анри Жюль	МАТ-21	Эйлер Леонард Пауль
Лейбниц Готфрид Вильгельм	МАТ-21	Эйлер Леонард Пауль
Толстой Лев Николаевич	ЛИТ-31	Достоевский Федор Михайлович
Чехов Антон Павлович	ЛИТ-31	Достоевский Федор Михайлович
Тургенев Иван Сергеевич	ЛИТ-31	Достоевский Федор Михайлович
Гончаров Иван Александрович	ЛИТ-31	Достоевский Федор Михайлович
Бунин Иван Алексеевич	ЛИТ-31	Достоевский Федор Михайлович
Ахматова Анна Андреевна	ЛИТ-31	Достоевский Федор Михайлович
Пастернак Борис Леонидович	ЛИТ-31	Достоевский Федор Михайлович
Набоков Владимир Владимирович	ЛИТ-31	Достоевский Федор Михайлович
Пикассо Пабло Руис	ИСК-91	Микеланджело Буонарроти Тито
Рембрандт Харменс ван Рейн	ИСК-91	Микеланджело Буонарроти Тито
ван Гог Винсент Виллем	ИСК-91	Микеланджело Буонарроти Тито
Дали Сальвадор Доминго	ИСК-91	Микеланджело Буонарроти Тито
Моне Клод Оскар	ИСК-91	Микеланджело Буонарроти Тито
Рубенс Питер Пауль	ИСК-91	Микеланджело Буонарроти Тито
Гоген Поль Эжен	ИСК-91	Микеланджело Буонарроти Тито
Тьюринг Алан Мэтисон	ИНФ-101	Нейман Янош Лайош
Кнут Дональд Эрвин	ИНФ-101	Нейман Янош Лайош
Дейкстра Эдсгер Вибе	ИНФ-101	Нейман Янош Лайош
Хоппер Грейс Мюррей	ИНФ-101	Нейман Янош Лайош
Столлман Ричард Мэттью	ИНФ-101	Нейман Янош Лайош
Торвальдс Линус Бенедикт	ИНФ-101	Нейман Янош Лайош
Керниган Брайан Уилсон	ИНФ-101	Нейман Янош Лайош
Ритчи Деннис МакАлистер	ИНФ-101	Нейман Янош Лайош
Бутлеров Александр Михайлович	ХИМ-61	Менделеев Дмитрий Иванович
Кекуле Август Фридрих	ХИМ-61	Менделеев Дмитрий Иванович
Аррениус Сванте Август	ХИМ-61	Менделеев Дмитрий Иванович
Оствальд Вильгельм Фридрих	ХИМ-61	Менделеев Дмитрий Иванович
Берцелиус Йёнс Якоб	ХИМ-61	Менделеев Дмитрий Иванович
Пристли Джозеф Грин	ХИМ-61	Менделеев Дмитрий Иванович
Лавуазье Антуан Лоран	ХИМ-61	Менделеев Дмитрий Иванович
Моцарт Вольфганг Амадей	МУЗ-81	Бах Иоганн Себастьян
Бетховен Людвиг ван	МУЗ-81	Бах Иоганн Себастьян
Шопен Фредерик Франсуа	МУЗ-81	Бах Иоганн Себастьян
Лист Ференц Йожеф	МУЗ-81	Бах Иоганн Себастьян
Чайковский Петр Ильич	МУЗ-81	Бах Иоганн Себастьян
Шуман Роберт Александер	МУЗ-81	Бах Иоганн Себастьян
Штраус Иоганн Батист	МУЗ-81	Бах Иоганн Себастьян
Вивальди Антонио Лучо	МУЗ-81	Бах Иоганн Себастьян